Greedy : طماع
Revenge : انتقام
Tough : صعب
Cost : تكلفة
Spoil : تلف
Know : معرفة
Goal : هدف
Praise : إشادة
Need : حاجة
Tolerate : تحمل
Irritate : يزعج
Honest : صادق
Neighbour : جار
Exception : استثناء
Imitate : تقليد
Violence : عنف
Intention : نية
Illusion : وهم
Willpower : إرادة
Flexible : مرن
Lucky : محظوظ
Wicked : شرير
Weak : ضعيف
Enemy :  عدو
Effect : تأثير
Demand : مطلب
Spend : ينفق
Accurate : دقيق
Arrogant : متعجرف
Learn : تعلم
Allow : السماح
Hesitate : تردد
Bother : يزعج
Stubborn : عنيد
Rotten : فاسد
Ultimate : نهائي
Almost : تقريباً
Innocent : بريء
Guilty : مذنب
Perhaps : ربما
Result : نتيجة
Faithful : مخلص
Blame : اتهام
Rely : يعتمد
Actually : في الواقع
Destroy : يدمر
Wink : يغمز
Burden : عبء
Justify : يبرر
Wise : حكيم
Priority : أولوية
Regular : منتظم
Risky : خطير
Agree : سهمت هونا